start
-
level1
-
-
>>>>>>>>
>.>.....
>.......
>.......
........
........
>..>....
>>>>>>>>
1,2,b
2,2,b
3,2,b
7,6,s
6,6,s
5,6,s
4,6,s

level1
level2
level4
level3
start
>>>>>>>>
>.>.....
>.......
>.......
........
........
>..>....
>>>>>>>>

level2
-
-
level1
-
>>>>>>>>
>.>.....
>.......
>.......
........
........
>..>....
>>>>>>>>