start
-
level1
-
-
>>>>>>>>
>.>.....
>.......
>.......
........
........
>..>....
>>>>>>>>
2,1,b

level1
level2
level4
level3
start
>>>>>>>>
>.>.....
>.......
>.......
........
........
>..>....
>>>>>>>>

level2
-
-
level1
-
>>>>>>>>
>.>.....
>.......
>.......
........
........
>..>....
>>>>>>>>